12222222222227
25555555555554
25344353444354
26400454000454
25344353444353
25555555555555
25344353353444
25344354453443
25555554455554
12222154344304
00000254344303
00000254400000
00000254403440
22222153304000
00000050004000